     #####
     #   #
     #   #
   ###   ##
   #      #
 ### # ## #   ########
 #   # ## ##### $ .#
 #    @         $ .#
 ##### ### # ## $ .#
     #     ###########
     #######