     #####
     #   #
     #   #
   ###   ##
   #      #
 ### # ## #   ########
 #   # ## ##### $ .  #
 #    @         $  . #
 ##### ### # ## $   .#
     #     ###########
     #######